NO ./textures/north.xpm
SO ./textures/south.xpm
WE ./textures/west.xpm
EA ./textures/east.xpm

F 255,255,255
C 0,0,0
    1111111
    100000111111111
1111100000000000001
1000100010001000001
1000000000000000001
1000000000000000001
10000000N0000000001
1111111111111111111