NO ./textures/north.xpm
SO ./textures/south.xpm
WE ./textures/west.xpm
EA ./textures/east.xpm

C 35,19,73
F 15,6,40

                     111
                    10001
 111111111111111111100001
1000000000000000000000001
1000000000000N00000000001
 111111111111111111110001
                    10001
                    1000011111111111111111111
                    10000000000000000000000001
                    1000000000000000000000001
                     111111111111111111111111