NO ./textures2/north.xpm
SO ./textures2/south.xpm
WE ./textures2/west.xpm
EA ./textures2/east.xpm

C 35,19,73
F 15,6,40

11111
10001 
10N01
10001 
11111
